REB = "countries/Rebels.txt"
PIR = "countries/Pirates.txt"
NAT = "countries/Natives.txt"

XXA = "countries/ImperiumOfMan.txt"
XXB = "countries/AdeptusMechanicus.txt"
XXC = "countries/Thokt.txt"
XXD = "countries/Grax.txt"
XXE = "countries/SaimHann.txt"
XXF = "countries/Calverna.txt"
XXG = "countries/Ogdobekh.txt"
XXH = "countries/Macharia.txt"
XXI = "countries/AlphaLegion.txt"
XXJ = "countries/SepktraalCult.txt"
XXK = "countries/Gasomere.txt"
XXL = "countries/Lugganath.txt"
XXM = "countries/Aggaros.txt"
XXN = "countries/Trantis.txt"
XXO = "countries/NightReapers.txt"
XXP = "countries/Sarnekh.txt"
XXQ = "countries/Dregruk.txt" #
XXR = "countries/Nervkor.txt"
XXS = "countries/Sanctia.txt"
XXT = "countries/CultOfTheBladedCog.txt"
XXU = "countries/Vindalex.txt"   
XXV = "countries/OmegaMao.txt"
XXW = "countries/DaxosGemini.txt"
XXX = "countries/Dregdakka.txt"
XXY = "countries/Sherilax.txt"
XXZ = "countries/CypraMundi.txt"
XYA = "countries/Tuchulcha.txt"
XYB = "countries/HiveFleetLeviathan.txt"
XYC = "countries/OrdexThaag.txt"
XYD = "countries/MordaPrime.txt"
XYE = "countries/Anphelion.txt"
XYF = "countries/Garaghak.txt"
XYG = "countries/ThousandSons.txt"
XYH = "countries/Cleaved.txt"
XYI = "countries/Grisgrease.txt"
XYJ = "countries/Abheilung.txt"
XYK = "countries/Precipice.txt"
XYL = "countries/Credence.txt"
XYM = "countries/Athelaq.txt"
XYN = "countries/Octarius.txt"
XYO = "countries/BielTan.txt"
XYP = "countries/ZhaoArkkad.txt"
XYQ = "countries/Arachnus.txt"
XYR = "countries/SpaceWolves.txt"
XYS = "countries/Catachan.txt"
XYT = "countries/Angstrom.txt"
XYU = "countries/Brogrod.txt"
XYV = "countries/RynnsWorld.txt"
XYW = "countries/Bakka.txt"
XYX = "countries/Gathalamor.txt"
XYY = "countries/DarkSons.txt"        
XYZ = "countries/Tallarn.txt"
XZA = "countries/Ophelia.txt"
XZB = "countries/Iybraesil.txt"
XZC = "countries/Ulthwe.txt"
XZD = "countries/Haltmoat.txt"
XZE = "countries/PortAquila.txt"
XZF = "countries/HouseThorne.txt"
XZG = "countries/Mklrathirix.txt"
XZH = "countries/EbonSentinels.txt"
XZI = "countries/IronHands.txt"
XZJ = "countries/Norada.txt"
XZK = "countries/Hydraphur.txt"
XZL = "countries/Kaelor.txt"
XZM = "countries/Bigtoof.txt"
XZN = "countries/Kinbriar.txt"
XZO = "countries/LordsOfSilence.txt"
XZP = "countries/Gragnatz.txt"
XZQ = "countries/YmeLoc.txt"
XZR = "countries/Necromunda.txt" #
XZS = "countries/Armageddon.txt"
XZT = "countries/GreatWaaagh.txt"
XZU = "countries/Juno.txt"
XZV = "countries/Milhand.txt"
XZW = "countries/LegioAtarus.txt"
XZX = "countries/KakkbadFreebooterz.txt"
XZY = "countries/Nephrekh.txt"
XZZ = "countries/OrderOfIron.txt"
XAA = "countries/Maynarkh.txt"
XAB = "countries/Naiatoc.txt"
XAC = "countries/Executioners.txt"
XAD = "countries/Orpheus.txt"
XAE = "countries/AngelsRevenant.txt"
XAF = "countries/NightSwords.txt"
XAG = "countries/Aleusis.txt"
XAH = "countries/DarkEagles.txt"
XAI = "countries/Cretacia.txt"
XAJ = "countries/Salamanders.txt"
XAK = "countries/Baatorus.txt"
XAL = "countries/CelestialGuard.txt"
XAM = "countries/HouseMortan.txt"
XAN = "countries/WhiteTemplars.txt"
XAO = "countries/SonsOfMedusa.txt"
XAP = "countries/ChildrenOfInheritance.txt"
XAQ = "countries/HouseDraconis.txt"
XAR = "countries/Kdask.txt"
XAS = "countries/Innerwyrm.txt"
XAT = "countries/Honsou.txt"
XAU = "countries/Olmec.txt"
XAV = "countries/Altansar.txt"
XAW = "countries/Beublghor.txt"
XAX = "countries/Kalibrax.txt"
XAY = "countries/RedCorsairs.txt"
XAZ = "countries/WhiteScars.txt"
XBA = "countries/Methalor.txt"
XBB = "countries/Furimancers.txt"
XBC = "countries/Maulers.txt"
XBD = "countries/KeepExtremis.txt"
XBE = "countries/SkySentinels.txt"
XBF = "countries/Akator.txt"
XBG = "countries/RedWolves.txt"
XBH = "countries/Morros.txt"
XBI = "countries/Morlond.txt"
XBJ = "countries/Ashek.txt"
XBK = "countries/NightWatch.txt"
XBL = "countries/CadmiusTertius.txt"
XBM = "countries/Askellon.txt"
XBN = "countries/Vejuvium.txt"
XBO = "countries/Machorta.txt"
XBP = "countries/Foresworn.txt"
XBQ = "countries/Grimtoof.txt"
XBR = "countries/SeveranDominate.txt"
XBS = "countries/Scintilla.txt"
XBT = "countries/Malfi.txt"
XBU = "countries/Vorketh.txt"
XBV = "countries/CultOfSollex.txt"
XBW = "countries/Elros.txt"
XBX = "countries/Belecane.txt"
XBY = "countries/StormWardens.txt"
XBZ = "countries/ScarusGarrison.txt"
XCA = "countries/RavenGuard.txt"
XCB = "countries/KronusHegemony.txt"
XCC = "countries/Daethe.txt"
XCD = "countries/Tirathain.txt"
XCE = "countries/Svehlin.txt"
XCF = "countries/Ishariel.txt"
XCG = "countries/Prescience.txt"
XCH = "countries/Cadmus.txt"
XCI = "countries/Tyr.txt"
XCJ = "countries/CultHydraic.txt"
XCK = "countries/ObsidianRose.txt"
XCL = "countries/GreaterThurianLeague.txt"
XCM = "countries/GhuloIndustrialComplex.txt"
XCN = "countries/YmyrConglomerate.txt"
XCO = "countries/Vigilus.txt"
XCP = "countries/Speedwaaagh.txt"
XCQ = "countries/PauperPrinces.txt"
XCR = "countries/AmaranthineSyndicate.txt"
XCS = "countries/Fenksworld.txt"
XCT = "countries/Fervious.txt"
XCU = "countries/Archaos.txt"
XCV = "countries/Kantakkha.txt"
XCW = "countries/EmpireOfTheSevered.txt"
XCX = "countries/DarkAngels.txt"
XCY = "countries/ChancelleryCourt.txt"
XCZ = "countries/Dyvanakh.txt"
XDA = "countries/Zantragora.txt"
XDB = "countries/Sekemtar.txt"
XDC = "countries/Thranix.txt"
XDD = "countries/GhanshorWarhost.txt"
XDE = "countries/TigersArgent.txt"
XDF = "countries/HiveCult.txt"
XDG = "countries/HowlingGriffons.txt"
XDH = "countries/LionsProtectorate.txt"
XDI = "countries/Sarum.txt"
XDJ = "countries/BloodAngels.txt"
XDK = "countries/Chemarium.txt"
XDL = "countries/Shern.txt"
XDM = "countries/Mephrit.txt"
XDN = "countries/HouseBorgius.txt"
XDO = "countries/Lucius.txt"
XDP = "countries/HouseVyronii.txt"
XDQ = "countries/Lanorra.txt"
XDR = "countries/Seidon.txt"
XDS = "countries/Rafnar.txt"
XDT = "countries/MortarionsAnvil.txt"
XDU = "countries/GhonisUltra.txt"
XDV = "countries/Crystallax.txt"
XDW = "countries/CruachMhorn.txt"
XDX = "countries/UrsidheKa.txt"
XDY = "countries/Chincare.txt"
XDZ = "countries/SanLeor.txt"
XEA = "countries/Boucherin.txt"
XEB = "countries/BloodPact.txt"
XEC = "countries/Formal.txt"
XED = "countries/Nonimax.txt"
XEE = "countries/Verghast.txt"
XEF = "countries/Enothis.txt"
XEG = "countries/Qorl.txt"
XEH = "countries/StarKindred.txt"
XEI = "countries/Novokh.txt"
XEJ = "countries/Venomariners.txt"
XEK = "countries/CastilosNullifact.txt"
XEL = "countries/HouseGriffith.txt"
XEM = "countries/Charadon.txt"
XEN = "countries/UralekPrime.txt"
XEO = "countries/HouseHerpetrax.txt"
XEP = "countries/Alaitoc.txt"
XEQ = "countries/LegioVenator.txt"
XER = "countries/Cyclothrathe.txt"
XES = "countries/Hyrekh.txt"
XET = "countries/Szarekhan.txt"
XEU = "countries/Solemnace.txt"
XEV = "countries/Sautekh.txt"
XEW = "countries/Nihilakh.txt"
XEX = "countries/PyrrhianEternals.txt"
XEY = "countries/HouseTerryn.txt"
XEZ = "countries/HouseOrhlacc.txt"
XFA = "countries/Oxatan.txt"
XFB = "countries/Necris.txt"
XFC = "countries/Zarathusa.txt"
XFD = "countries/Ziaphoria.txt"
XFE = "countries/SanguaTerra.txt"
XFF = "countries/Agripinaa.txt"
XFG = "countries/GretiennesGarden.txt"
XFH = "countries/HouseHawkshroud.txt"
XFI = "countries/SilverSkulls.txt"
XFJ = "countries/StormHawks.txt"
XFK = "countries/Vacuna.txt"
XFL = "countries/Canto.txt"
XFM = "countries/CoronisAgathon.txt"
XFN = "countries/PortMaw.txt"
XFO = "countries/Goth.txt"
XFP = "countries/Mpandex.txt"
XFQ = "countries/Mezoa.txt"
XFR = "countries/AhiTipua.txt"
XFS = "countries/Mortguard.txt"
XFT = "countries/Exotia.txt"
XFU = "countries/RainbowWarriors.txt"
XFV = "countries/SonsOfOrar.txt"
XFW = "countries/HouseVulker.txt"
XFX = "countries/Corinthe.txt"
XFY = "countries/DeathStrike.txt"
XFZ = "countries/Cilix.txt"
XGA = "countries/CrimsonRaptors.txt"
XGB = "countries/TyphusWarhost.txt"
XGC = "countries/Metalica.txt"
XGD = "countries/Garagos.txt"
XGE = "countries/Jagga.txt"
XGF = "countries/Tau.txt"
XGG = "countries/FarsightEnclaves.txt"
XGH = "countries/HouseRaven.txt"
XGI = "countries/CrimsonPaladins.txt"
XGJ = "countries/Alsanta.txt"
XGK = "countries/Ultramar.txt"
XGL = "countries/Nazdreg.txt"
XGM = "countries/Pech.txt"
XGN = "countries/Drazak.txt"
XGO = "countries/Cegorachi.txt"
XGP = "countries/Rhidol.txt"
XGQ = "countries/Ohma.txt"
XGR = "countries/DeathSpecters.txt"
XGS = "countries/Derovire.txt"
XGT = "countries/Cnath.txt"
XGU = "countries/Solitude.txt"
XGV = "countries/Gerontius.txt"
XGW = "countries/FortPykman.txt"
XGX = "countries/UlanHuda.txt"
XGY = "countries/Eqhai.txt"
XGZ = "countries/Constantium.txt"
XHA = "countries/AstralKnights.txt"
XHB = "countries/BellusPrime.txt"
XHC = "countries/MasuchiParr.txt"
XHD = "countries/TessersFolly.txt"
XHE = "countries/RegentsOfGheren.txt"
XHF = "countries/DragonLords.txt"
XHG = "countries/TriplexHall.txt"
XHH = "countries/EyeOfDamocles.txt"
XHI = "countries/SurtrsWake.txt"
XHJ = "countries/AuroraChapter.txt"
XHK = "countries/GenesisChapter.txt"
XHL = "countries/IronHounds.txt"
XHM = "countries/FireLords.txt"
XHN = "countries/RedHunters.txt"
XHO = "countries/StarDragons.txt"
XHP = "countries/LegionOfNight.txt"
XHQ = "countries/WhitePanthers.txt"
XHR = "countries/SkullBearers.txt"
XHS = "countries/Quilan.txt"
XHT = "countries/Moltova.txt"
XHU = "countries/HawkLords.txt"
XHV = "countries/StygiusGarrison.txt"
XHW = "countries/Orar.txt"
XHX = "countries/AvengingSons.txt"
XHY = "countries/WatcherKeep.txt"
XHZ = "countries/ScourgeStars.txt"
XIA = "countries/Iyanden.txt"
XIB = "countries/GretchinRevolutionaryCommittee.txt"
XIC = "countries/Digganobz.txt"
XID = "countries/Gorkamorka.txt"
XIE = "countries/Muties.txt"
XIF = "countries/IronWarriors.txt"
XIG = "countries/EmperorsChildren.txt"
XIH = "countries/CorpseGrinderCult.txt"
XII = "countries/IronheadSquats.txt"
XIJ = "countries/CultOfTheSlitheringStar.txt"
XIK = "countries/HouseOrlok.txt"
XIL = "countries/HouseCawdor.txt"
XIM = "countries/HouseEscher.txt"
XIN = "countries/HouseVanSaar.txt"
XIO = "countries/DaSkull.txt"
XIP = "countries/ImmortalCult.txt"
XIQ = "countries/HouseDelaque.txt"
XIR = "countries/Vespids.txt"
XIS = "countries/Mirienh.txt"
XIT = "countries/Charnovokh.txt"
XIU = "countries/IronLords.txt"
XIV = "countries/Barghesi.txt"
XIW = "countries/Samech.txt"
XIX = "countries/Myrandias.txt"
XIY = "countries/ScythesOfTheEmperor.txt"
XIZ = "countries/TheDisciples.txt"
XJA = "countries/HiveFleetHydra.txt"
XJB = "countries/ThexianTradeEmpire.txt"
XJC = "countries/DoomLegion.txt"
XJD = "countries/Elysia.txt"
XJE = "countries/GlatchianCreed.txt"
XJF = "countries/Haephos.txt"
XJG = "countries/Kragh.txt"
XJH = "countries/Excalibris.txt"
XJI = "countries/Syph.txt"
XJJ = "countries/Gladius.txt"
XJK = "countries/GreyGiants.txt"
XJL = "countries/Oelil.txt"
XJM = "countries/SaranLuxor.txt"
XJN = "countries/SerpentsTeeth.txt"
XJO = "countries/Oltep.txt"
XJP = "countries/Thanatos.txt"
XJQ = "countries/HouseNineteen.txt"
XJR = "countries/IronHawks.txt"
XJS = "countries/Razlivanova.txt"
XJT = "countries/Gulgorahd.txt"
XJU = "countries/Rianoen.txt"
XJV = "countries/HonoredSons.txt"
XJW = "countries/Shrik.txt"
XJX = "countries/ShadowHive.txt"
XJY = "countries/FortNexus.txt"
XJZ = "countries/Krongar.txt"
XKA = "countries/Borlac.txt"
XKB = "countries/NightSentinels.txt"
XKC = "countries/SonsOfGathalor.txt"
XKD = "countries/Farstalkers.txt"
XKE = "countries/Novamarines.txt"
XKF = "countries/Avarris.txt"
XKG = "countries/Mymeara.txt"
XKH = "countries/Gethsemane.txt"
XKI = "countries/DeathGuard.txt"
XKJ = "countries/Butcherhorde.txt"
XKK = "countries/Slaughtersphere.txt"
XKL = "countries/Ironghast.txt"
XKM = "countries/Xana.txt"
XKN = "countries/BubonicusWarhost.txt"
XKO = "countries/WordBearers.txt"
XKP = "countries/BlackLegion.txt"
XKQ = "countries/Anathrax.txt"
XKR = "countries/Oliensis.txt"
XKS = "countries/FoolsParadise.txt"
XKT = "countries/Diesos.txt"
XKU = "countries/Temporia.txt"
XKV = "countries/ToxusWarhost.txt"
XKW = "countries/XaarnWarhost.txt"
XKX = "countries/ElyssarsirathWarhost.txt"
XKY = "countries/Deathmongers.txt"
XKZ = "countries/Consortium.txt"
XLA = "countries/Sublime.txt"
XLB = "countries/Techtriarchy.txt"
XLC = "countries/DarkHunters.txt"
XLD = "countries/Firebreathers.txt"
XLE = "countries/Septeryx.txt"
XLF = "countries/CultOfOhn.txt"
XLG = "countries/ChrobdyrFerrophagites.txt"
XLH = "countries/IndomitusPoint.txt"
XLI = "countries/CrimsonFists.txt"
XLJ = "countries/PraetorsOfOrpheus.txt"
XLK = "countries/Oruskh.txt"
XLL = "countries/TransHyperianAlliance.txt"
XLM = "countries/UraniSurtrRegulates.txt"
XLN = "countries/Uphrateus.txt"
XLO = "countries/Kathalon.txt"
XLP = "countries/Nardonis.txt"
XLQ = "countries/CultOfTheRustedClaw.txt"
XLR = "countries/SonsOfJormungandr.txt"
XLS = "countries/Nekthyst.txt"
XLT = "countries/Anvillus.txt"
XLU = "countries/UtanMagna.txt"
XLV = "countries/TauSphere.txt"
XLW = "countries/Incaladion.txt"
XLX = "countries/Dsholtu.txt"
XLY = "countries/HouseScythe.txt"
XLZ = "countries/Occulid.txt"
XMA = "countries/Kardenath.txt"
XMB = "countries/DecimusWarhost.txt"
XMC = "countries/GuainWarband.txt"
XMD = "countries/Trevenum.txt"
XME = "countries/RubyCrescents.txt"
XMF = "countries/TenThousandEyes.txt"
XMG = "countries/NeoBaku.txt"
XMH = "countries/Matarakh.txt"
XMI = "countries/Syban.txt"
XMJ = "countries/Donarathi.txt"
XMK = "countries/Vassalian.txt"
XML = "countries/HiveFleetOuroboros.txt"
XMM = "countries/CultOfChalkonides.txt"
XMN = "countries/Elytrio.txt"
XMO = "countries/BloodPrince.txt"
XMP = "countries/Drakaasi.txt"
XMQ = "countries/SigmaUlstari.txt"
XMR = "countries/Bhasca.txt"
XMS = "countries/Ursulia.txt" #
XMT = "countries/LeviathanTendril.txt"
XMU = "countries/HouseAramos.txt"
XMV = "countries/KnausLambda.txt"
XMW = "countries/Vaen.txt"
XMX = "countries/ChalnathGarrison.txt"
XMY = "countries/Fydae.txt" #
XMZ = "countries/AshenClaws.txt" #
XNA = "countries/DovarGarrison.txt" #
XNB = "countries/Hedonistarii.txt" #
XNC = "countries/Lentrel.txt" #
XND = "countries/Resplendis.txt" #
XNE = "countries/Altevfor.txt" #
XNF = "countries/HouseColKhak.txt" #
XNG = "countries/MarinesErrant.txt" #
XNH = "countries/Archona.txt" #
XNI = "countries/Mortant.txt" #
XNJ = "countries/Cirillo.txt" #
XNK = "countries/HouseMakabius.txt" #
XNL = "countries/Argentor.txt" #
XNM = "countries/KnightsOfTheRaven.txt" #
XNN = "countries/ImperialReavers.txt" #
XNO = "countries/Araednnil.txt" #
XNP = "countries/EmperorsSpears.txt" #
XNQ = "countries/Icnarus.txt" #
XNR = "countries/Agathon.txt" #
XNS = "countries/Anuaris.txt" #
XNT = "countries/NepthysMadrigal.txt" #
XNU = "countries/CultFourArmedEmperor.txt" #
XNV = "countries/Ichar.txt" #
XNW = "countries/Amontep.txt" #
XNX = "countries/Nameless.txt" #
XNY = "countries/Esthea.txt" #
XNZ = "countries/Sycorax.txt" #
XOA = "countries/Jerulas.txt" #
XOB = "countries/Stygies.txt" #
XOC = "countries/Harbingers.txt" #
XOD = "countries/Gellephera.txt" #
XOE = "countries/Kinshara.txt" #
XOF = "countries/Subinus.txt" #
XOG = "countries/IronKnights.txt" #
XOH = "countries/Absolvers.txt" #
XOI = "countries/Damnos.txt" #
